#########################################
#...#.......#.........#...........#...#.#
#.#.###.#.###.###.###.###.#.#####.#.#.#.#
#.#...#.#.......#.#.....#.#.#.....#.#.#.#
#.###.#########.#.#####.###.#.#####.#.#.#
#.#O#.#.....#...#...#.......#.#...#.#.#.#
#.#.#.#.###.#######.#########.#.#.#.#.#.#
#.#.....#.#...#...#...#.....#...#...#.#.#
#.#######.###.#.#.###.#.#.###########.#.#
#.......#...#...#.#...#.#.......#...#...#
#.#####.#.#######.#.#######.#####.#.###.#
#.#...#.#.........#...#...#.......#...#.#
#.###.#.###.#########.#.#.###.#####.#.#.#
#.....#...#.#...#.....#.#...#.....#.#.#.#
#####.###.#.#.#.###.#.#.###.#######.#.#.#
#.....#...#...#.....#.#.#.#...#.....#.#.#
#.#####.#######.#######.#.###.#.#######.#
#.#...#...#.....#...#...#.#...#.#.......#
#.###.###.###.###.#.#.###.#.###.#.#######
#.......#...#.#...#...#...#...#.#.....#.#
#.#########.#.#.#######.#####.#.#####.#.#
#.#.....#...#.#......S#.#.....#.#.....#.#
###.###.#.###.#########.#.#####.#.#####.#
#...#...#.#.#...#...#...#.....#.#.#...#.#
#.###.###.#.#.###.#.#.#.#####.#.#.#.#.#.#
#.#.......#...#...#...#.....#.#.#...#.#.#
#.#########.###.###########.#.#.#####.#.#
#.#.....#...#.#.#.....#...#...#.....#.#.#
#.#.###.#.###.#.#.#.###.#.#####.###.#.#.#
#.#.#.#.#.#...#.#.#.#...#.....#.#...#...#
#.#.#.#.#.###.#.###.#.#####.#.#.#.#####.#
#.#...#.#...#.#...#.......#.#.#.#.#.....#
#.#.###.###.#.###.#######.#.#.###.#.#####
#.#.#...#.......#...#.....#.#.#...#.#...#
#.#.#.#####.#######.#.#####.#.#.#.#.#.#.#
#...#.#...#.#...#...#.#.#...#...#.#.#.#.#
#####.#.#.###.#.#.###.#.#.#######.#.###.#
#...#...#.....#...#.#...#...#...#.#...#.#
#.#.###############.###.###.#.#.#####.#.#
#.#.......................#...#.........#
#########################################